# Input                 | keys    |  Stage 1 Output  |   Stage 2 Output  | Final Output
IN_0 | 0000000000000001 | 00110   | 0000000000000011 | 00000000000000110 | 0000000000000011
IN_1 | 1111111111111111 | 01100   | 1111111111111011 | 11111111111110111 | 0111111111111011
IN_2 | 1010101010101010 | 10011   | 1010101010100100 | 10101010101001001 | 0010101010100100
IN_3 | 0101010101010101 | 11001   | 1010101010100110 | 10101010101001101 | 0010101010100110
IN_4 | 0001111000011110 | 00100   | 0011110000111101 | 00111100001111011 | 1011110000111101
IN_5 | 1110000111100001 | 11010   | 0011110000100110 | 00111100001001100 | 0011110000100110
IN_6 | 1000000000000001 | 10011   | 0000000000010100 | 00000000000101001 | 1000000000010100
IN_7 | 0000000011111111 | 11001   | 0001111111100110 | 00011111111001101 | 1001111111100110
