# Input                |keys      |   Stage 1 Output | Stage 2 Output | Final Output
IN_0 | 0000000000000001|001000    | 0000000000000011 | 0000000000000110 | 0000000000000011
IN_1 | 1111111111111111|011001    | 1111111111111011 | 1111111111110110 | 0111111111111011
IN_2 | 1010101010101010|100010    | 1010101010100100 | 0000000000000000 | 0000000000000000
IN_3 | 0101010101010101|110011    | 0101010101000110 | 1111111111111111 | 0111111111111111
IN_4 | 0001111000011110|001000    | 0011110000111101 | 0111100001111011 | 0011110000111101
IN_5 | 1110000111100001|110011    | 0000111100001011 | 0001111000010110 | 0000111100001011
IN_6 | 1000000000000001|100010    | 0000000000010100 | 0000000000000000 | 0000000000000000
IN_7 | 0000000011111111|110011    | 0011111111000110 | 1111111111111111 | 0111111111111111
