# Input                 | keys    |   Stage 1 Output | Stage 2 Output | Final Output
IN_0 | 0000000000000001 | 00110   | 0000000000000101 | 00000000000001010 | 0000000000000101
IN_1 | 1111111111111111 | 01100   | 1111111111111011 | 11111111111110111 | 0111111111111011
IN_2 | 1010101010101010 | 10011   | 1010101010000011 | 10101010100000111 | 0010101010000011
IN_3 | 0101010101010101 | 11001   | 1010101000000011 | 10101010000000111 | 0010101000000011
IN_4 | 0001111000011110 | 00100   | 0011110000111111 | 00111100001111110 | 0011110000111111
IN_5 | 1110000111100001 | 11010   | 0001111000010011 | 00011110000100110 | 0001111000010011
IN_6 | 1000000000000001 | 10011   | 0000000000010011 | 00000000000100111 | 1000000000010011
IN_7 | 0000000011111111 | 11001   | 0001111111100011 | 00011111111000111 | 1001111111100011
